11111111111111111111111111111111111111111111111111111001110111111111111111111111111111111111111111111111111
11111111111111111111111111111111111111111111111111111111111111111111111111111111111111111111111111111111111
11111111111111111111111111111111111111111111111111111111111111111111111111111111111111111111111111111111111
11111111111111111111111111111111111111111111111111111111111111111111111111111111111111111111111111111111111
11111111111111111111111111111111111111111111111111111111010111111111111111111111111111111111111111111111111
11111111111111111111111111111111111111111111111111111111000111111111111111111111111111111111111111111111111
11111111111111111111111111111111111111111111111111110111000111111111001111111111111111111111111111111111111
11111111111111111111111111111111111111111111111111111110000111111110011111111111111111111111111111111111111
11111111111111111111111111111111111111111111111111111110000111111110011111111111111111111111111111111111111
11111111111111111111111111111111111111111111111111111110000011111110011111111111111111111111111111111111111
11111111111111111111111111111111111111111111111111111111000011111110011111111111111111111111111111111111111
11111111111111111111111111111111111111111111111111111111000011111100011111111111111111111111111111111111111
11111111111111111111111111111111111111111111111111111111000001100000011111111111111111111111111111111111111
11111111111111111111111111111111111111111111111111111111000000000000011111111111111111111111111111111111111
11111111111111111111111111111111111111111111111111110010000000000000011111111111111111111111111111111111111
11111111111111111111111111111111111111111111111111100000000000000000011111111111111111111111111111111111111
11111111111111111111111111111111111111111111111110000000000000000000011111111111111111111111111111111111111
11111111111111111111111111111111111111111111111110000000000000000000111111111111111111111111111111111111111
11111111111111111111111111111111111111111111111110000000000000000001111111111111111111111111111111111111111
11111111111111111111111111111111111111111111111110000000000000000001111111111111111111111111111111111111111
11111111111111111111111111111111111111111111111111000000000000000001111111111111111111111111111111111111111
11111111111111111111111111111111111111111111111111000000000000000001111111111111111111111111111111111111111
11111111111111111111111111111111111111111111111110000000000000000011111111111111111111111111111111111111111
11111111111111111111111111111111111111111111111100000000000000000001111111111111111111111111111111111111111
11111111111111111111111111111111111111111111111000000000000000000000111111111111111111111111111111111111111
11111111111111111111111111111111111111111111111000000000000000000000111111111111111111111111111111111111111
11111111111111111111111111111111111111111111111000000000000000000000001111111111111111111111111111111111111
11111111111111111111111111111111111111111111111000000000000000000000001111111111111111111111111111111111111
11111111111111111111111111111111111111111111110000000000011000000000001111111111111111111111111111111111111
11111111111111111111111111111111111111111111100000000000011100000000001111111111111111111111111111111111111
11111111111111111111111111111111111111111111100000000000111100000000001111111111111111111111111111111111111
11111111111111111111111111111111111111111111000000000001111110000000001111111111111111111111111111111111111
11111111111111111111111111111111111111111111000000000001111111000000000111111111111111111111111111111111111
11111111111111111111111111111111111111000110000011000001111111000000000000111111111111111111111111111111111
11111111111111111111111111111111111110000000000011000001111111100000000000011111111111111111111111111111111
11111111111111111111111111111111000000000000000000000011111111100000000000011111111111111111111111111111111
11111111111111111111111111100011000000000000000000000011111111110000000000111111111111111111111111111111111
11111111111111111111111111100001100000000000000000100011111111111000000001111111111111111111111111111111111
11111111111111111111111111100000100000000000000001110011111111111100000000111111111111111111111111111111111
11111111111111111111111111100000000000000000000000111111111111111100000001111111111111111111111111111111111
01111111111111111111111111110000000001100000000000111111111111111110000011111111111111111111111111111111111
01111111111111111111111111111000000011110000000001111111111111111110000011111111111111111111111111111111111
11111111111111111111111111111000000001110000000000111111111111111111000111111111111111111111111111111111111
11111111110000011100011111111000000000110000000000011111111001111111111111111111111111111111111111111111111
01111111110000001111111110000000000000000000000000000011110001111111111111111111111111111111111111111111111
11111111110000011111111111000000000000000000000000000001000111111111111111111111111111111111111111111111111
11111111111000011111111111100000000000000000000000100000001111111111111111111111111111111111111111111111111
11111111111100001111111111111110000000000000000011111000011111111111111111111111111111111111111111111111111
11111111111110011111111111111111000000000000001111111101111111111111111111111111111111111111111111111111111
11111111111110111111111111111111000000000000111111111111111111111111111111111111111111111111111111111111111
11111111111101111111111111111111100000000000011111111111111111111111111111111111111111111111111111111111111
11111111111001111111111111110000000000000000000000000000000000000000011111111111111111111111111111111111111
11111111111111111111111111100000000000000000000000000000000000000000011111111111111111111111111111111111111
11111111111111111111111111000000000000000000000000000000000000000000011111111111111111111111111111111111111
11111111111111111111111111100000000000000000000000000000000000000000011111111111111111111111111111111111111
11111111111111111111111111100000000000000000000000000000000000000000011111111111111111111111111111111111111
11111111111111111111111111000000000000000000000000111111111110000001111111111111111111111111111111111111111
11111111111111111111111111100000000000000000000000101111111100000011111111111111111111111111111111111111111
11111111111111111111111111110000000000000000000000000111111000000111111111111111111111111111111111111111111
11111111111111111111111111111111110000000000000000001111110000001111111111111111111111111111111111111111111
11111111111111111111111111111111111100000000000001111111100000011111111111111111111111111111111111111111111
11111111111111111111111111111111111111000000000011111111000000111111111111111111111111111111111111111111111
11111111111111111111111111111111111111110000000000011110000001111111111111111111111111111111111111111111111
11111111111111111111111111111111111111100000000000001100000011111111111111111111111111111111111111111111111
11111111111111111111111111111111111111000000000000000000000111111111111111111111111111111111111111111111111
11111111111111111111111111111111111111100000000000000000001111111111111111111111111111111111111111111111111
11111111111111111111111111111111111111000000011000000000011111111111111111111111111111111111111111111111111
11111111111111111111111111111111111111000001111110000000000111111111111111111111111111111111111111111111101
11111111111111111111111111111111111111000001111110000000000001111111111111111111111111111111111111111111100
11111111111111111111111111111111111110000001111110000000000000111111111111111111111111111111111111111111101
11111111111111111111111111111111111110000011111100000100000000001111111111111111111111111111111111111111111
11111111111111111111111111111111111110000011111000001111000000000011111111111111111111111111111111111111111
11111111111111111111111111111111111100000011110000011111110000000000111111111111111111111111111111111111111
11111111111111111111111111111111111100000111100000011111111000000000001111111111111111111111111111111111111
11111111111111111111111111111111111100000111000000111111111110000000000111111100111111111111111111111111111
11111111111111111111111111111111111000000110000001111111111111100000000001110001111111111111111111111111111
11111111111111111111111111111111111000001100000011111111111111111000000000011111111111111111111111111111111
11111111111111111111111111111111111000001000000111111111111111111110000000011111111111111111111111111111111
11111111111111111111111111111111110000000000001111111111111111111111000000001111111111111111111111111111111
11111111111111111111111111111111110000000000011111111111111111111111110000011111111111111111111111111111111
11111111111111111111111111111111110000000000111111111111111111111111111100111111111111111111111111111111111
11111111111111111111111111111111100000000001111111111111111111111111111111111111111111111111111111111111111
11111111111111111111111111111111100000000011111111111111111111111111111111111111111111111111111111111111111
11111111111111111111111111111111000000000111111111111111111111111111111111111111111111111111111111111111111
11111111111111111111111111111111000000001111111111111111111111111111111111111111111111111111111111111111111
11111111111111111111111111111111000000011111111111111111111111111111111111111111111111111111111111111111111
11111111111111111111111111111110000000111111111111111111111111111111111111111111111111111111111111111111111
11111111111111111111111111111110000001111111111111111111111111111111111111111111111111111111111111111111111
11111111111111111111111111111110000011111111111111111111111111111111111111111111111111111111111111111111111
11111111111111111111111111111111000011110011111111111111111111111111111111111111111111111111111111111111111
11111111111111111111111111111111101111100001111111111111111111111111111111111111111111111111111111111111111
11111111111111111111111111111111111111100001111111111111111111111111111111111111111111111111111111111111111
11111111111111111111111111111111111111100001111111111111111111111111111111111111111111111111111111111111111
11111111111111111111111111111111111111100001111111111111111111111111111111111111111111111111111111111111111
11111111111111111111111111111111111111100001111111111111111111111111101111111111111111111111111111111111111
11111111111111111111111111111111111111111111111111111111111111111111100111111111111111111111111111111111111
11111111111111111111111111111111111111111111111111111111111111111111100111111111111111111111111111111111111
11111111111111111111111111111111111111111111111111111111111111111111111111111111111111111111111111111111111
11111111111111111111111111111111111111111111111111111111111111111111111111111111111111111111111111111111111
11111111111111111111111111111111111111111111111111111111111111111111111111111111111111111111111111111111111
11111111111111111111111111111111111111111111111111111111111111111111111111111111111111111111111111111111111
11111111111111111111111111111111111111111111111111111111111111111111111111111111111111111111111111111111111
11111111111111111111111111111111111111111111001111111111111100011111001111111111111111111111111111111111111
11111111111111111111111111111111111111111111000011111111111111111111111111111111111111111111111111111111111
11111111111111111111111111111111111111111111111111111111111111111111111111111111111111111111111111111111111
11111111111111111111111111111111111111111111111111111111111111111111111111111111111111111111111111111111111
53 48
106 107