333333333333333333333333333333333333333333333333333333333333333333333333333333333333333333333333333333333333333333333333333
333333333333333333333333333333333333333333333333333333333333333333333333333333333333333333333333333333333333333333333333333
333333333333333333333333333333333333333333333333333333333333333333333333333333333333333333333333333333333333333333333333333
333333333333333333333333333333333333333333333333333333333333333333333333333333333333333333333333333333333333333333333333333
333333333333333333333333333333333333333333333333333333333333333333333333333333333333333333333333333333333333333333333333333
333333333333333333333333333333333333333333333333333333333333333333333333333333333333333333333333333333333333333333333333333
333333333333333333333333333333333333333333333333333333333333333333333333333333333333333333333333333333333333333333333333333
333333333333333333333333333333333333333333333333333333333333333333333333333333333333333333333333333333333333333333333333333
333333333333333333333333333333333333333333333333333333333333333333333333333333333333333333333333333333333333333333333333333
333333333333333333333333333333333333333333333333333333333333333333333333333333333333333333333333333333333333333333333333333
333333333333333333333333333333333333333333333333333333333333333333333333333333333333333333333333333333333333333333333333333
333333333333333333333333333333333333333333333333333333333333333333333333333333333333333333333333333333333333333333333333333
333333333333333333333333333333333333333333333333333333333333333333333333333333333333333333333333333333333333333333333333333
333333333333333333333333333333333333333333333333333333333333333333333333333333333333333333333333333333333333333333333333333
333333333333333333333333333333333333333333333333333333333333333333333333333333333333303333333333333333333333333333333333333
333333333333333333333333333333333333333333333333333333333333333333333333333333333333303333333333333333333333333333333333333
333333333333333333333333333333333333333333333333333333333333333333333333333333333333303333333333333333333333333333333333333
333333333333333333333333333333333333333333333333333333333333333333333333333333333333303333333333333333333333333333333333333
333333333333333333333333333333333333333333333333333333333333333333333330333333333333333333333333333333333333333333333333333
333333333333333333333333333333333333333333333333333333333333333333333300333333333333333333333333333333333333333333333333333
333333333333333333333333333333333333333333333333333333333333333333333300333333333333303333333333333333333333333333333333333
333333333333333333333333333333333333333333333333333333333333333333333000333333333333303333333333333333333333333333333333333
333333333333333333333333333333333333333333333333333333333333333333333000333333333333300333333333333333333333333333333333333
333333333333333333333333333333333333333333333333333333333333333333333000333333333333300333333333333333333333333333333333333
333333333333333333333333333333333333333333333333333333333333333333333300333333333333300333333333333333333333333333333333333
333333333333333333333333333333333333333333333333333333333333333333333333333333333333300333333333333333333333333333333333333
333333333333333333333333333333333333333333333333333333333333333333333333333333003303300033333333333333333333333333333333333
333333333333333333333333333333333333333333333333333333333333333333333333333333030003300003333333333333333333333333333333333
333333333333333333333333333333333333333333333333333333333333333333333333333333000003300003333333333333333333333333333333333
333333333333333333333333333333333333333333333333333333333333333333333333303333033333300000033333333333333333333333333333333
333333333333333333333333333333333333333333333333333333333333333333333333303333333303300000003333333333333333333333333333333
333333333333333333333333333333333333333333333333333333333333333333333333333333333303300000000333333333333333333333333333333
333333333333333333333333333333333333333333333333333333333333333333333333333333333303300000000333333333333333333333333333333
333333333333333333333333333333333333333333333333333333333333333333333333333333333333300000000033333333333333333333333333333
333333333333333333333333333333333333333333333333333333333333333333333333333333333333300000000003333333333333333333333333333
333333333333333333333333333333333333333333333333333333333333333333333333333333333333300000000000033333333333333333333333333
333333333333333333333333333333333333333333333333333333333333333333333333333333333333300000000000000333333333333333333333333
333333333333333333333333333333333333333333333333333333333330033333333333333333333333300000000000003333333333333333333333333
333333333333333333333333333333333333333333333333333333333000003333333333333333333333300000000000003333333333333333333333333
333333333333333333333333333333333333333333333333333333330000003333333333333333333333300000000000033333333333333333333333333
333333333333333333333333333333333333333333333333333333333000003333333333333333333303300000000000030333333333333333333333333
333333333333333333333333333333333333333333333333333333333000033333333333333333333303300000000000000003333333333333333333333
333333333333333333333333333333333333333333333333333333333333333333333333333333333003300000300000000000333333333333333333333
333333333333333333333333333333333333333333333333333333333333333333333333333333333003300003333000000000333333333333333333333
333333333333333333333333333333333333333333333333333333333333333333333333333333333003300003333000000000033333333333333333333
333333333333333333333333333333333333333333333333333333333333333333333333333333333333300000330000000000033333333333333333333
333333333333333333333333333333333331133333333333333333333333333000000033333333333333300000000000000000003333333333333333333
333333333333333333333333333333333311111333333333333333333333300000000000333333333333333000000000000000000333333333333333333
333333333333333333333030300000033112211113333333333333333333000000000000333333333333333300000000000000003333333333333333333
333333333333333333330000000000033311222111133333333333333333300000000000033333333333333300000000000000003333333333333333333
333333333333333333300000000000003311112221111333333333333333330000000000033333333333333000000000000000033333333333333333333
333333333333333333300000000000003331111212211113333333333333330030000000033333333333300000000000000000333333333333333333333
333333333333333333300000000000111111111122122111111111111111111111111110003333333333300000000000000000333333333333333333333
333333333333333333330000000001111111111111211221111111111111111111111110000333333333300000000000000003333333333333333333333
333333333333333333330000000011222222222222222222222222222222222222222220000003333333330000000000000003333333333333333333333
333333333333333333300000000001122221111111112212111111111111111111121110000000333333330000000000000033333333333333333333333
333333333333333333300000000001122221111111111121111111111111111111211110000000003333330000000000000333333333333333333333333
333333333333333333000000000011222222211111111122111133300000000112111000000000003333333000000000003333330000000333333333333
333333333333333333300000000001111111222222222221221133330000001121110000000000000333330000000000003333333000000333333333333
333333333333333333330000000000111111111211111222222113333000011211100000000000000333333000000000033333333333000333333333333
333333333333333333333000000030033333111122111211111133333000112111000000000000000033330000000000333333333300000333333333333
333333333333333333333330000000333333331111221211111333333001121110000000000000000003300000000003333333330000000333333333333
333333333333333333333333300000333333333311112211113333333011211100000000000000000000000000000003333333300000000333333333333
333333333333333333333333300000333333333333112122111133333111211000000000000000000000000000000033333333330033333333333333333
333333333333333333333330000000033333333331112111211111331112110000000000000000000000000000000033333333330003333333333333333
333333333333333333333330000000000333333331121111122111111121100000000000000000000000000000000333333333333303333333333333333
333333333333333333333333000000000000033331121131111221111211000000000000000000000000000000000333333333333333333333333333333
333333333333333333333333300000000000000011121133311112212110000000000000000000000000000000000333333333333333333333333333333
333333333333333333333333300000000000000011211333333111122111100000000000000000000000000000000003333303333333333333333333333
333333333333333333333333300000000000000011211333333111211211111000000000000000000000000000000000000000333333333333333333333
333333333333333333333333000000000000000111211333333112111122111100000000000000000000000000000000000000333333333333333333333
333333333333333333333333300000000000000112110333331121131111221111000000000000000000000000000000000003333333333333333333333
333333333333333333333333330000000000000112113333311211033311112211110000000000000000000000000000000333333333333333333333333
333333333333333333333333330000000000001121113333112110033330111122111100000000003333300000000000003333333333333333333333333
333333333333333333333333333000000000001121103331121110333333011111211111000000333333333000000000333333333333333333333333333
333333333333333333333333333300000000001121103311211103333333330111122111100003333333333300000033333333333333333333333333333
333333333333333333333333333300000000011211103112111333333333333001111221111333333333003300003333333333333333333333333333333
333333333333333333333333333330000000011211001121113333333333333000011112211113333300000000003333333333333333333333333333333
333333333333333333333333333330000000011211011211133333333333333000000111122113333300000000333333333333333333333333333333333
333333333333333333333333333330000000112111112111333333333333333000003311111211333330000000333333333333333333333333333333333
333333333333333333333333333333000000112111121113333333333333333000033333111113333333000000333333333333333333333333333333333
333333333333333333333333333333000000112111121133333333333333033000033333331133333333330003333333333333333333333333333333333
333333333333333333333333333333333001121111211333333333333300000000033333333333333333333333333333333333333333333333333333333
333333333333333333333333333333333331121112113333333333330000000000033333333333333333333333333333333333333333333333333333333
333333333333333333333333333333333311121121103333300000000000000000033333333333333330033333333333333333333333333333333333333
333333333333333333333333333333333311211211033333300000000000000000003333333333333330000333333333333333333333333333333333333
333333333333333333333333333333333311212110333330000000000000000000003333333333333330000333333333333333333333333333333333333
333333333333333333333333333333333111221100333300000000000000000000003333333333333333333333333333333333333333333333333333333
333333333333333333333333333333333112211300333300000000000000000000003333333333333333333333333333333333333333333333333333333
333333333333333333333333333333333112113303333300000000000000000000003333333333333333333333333333333333333333333333333333333
333333333333333333333333333333333311113333333300000000000000000000003333333333333333333333333333333333333333333333333333333
333333333333333333333333333333333331333333333000000000000000000000033333330333333333333333333333333333333333333333333333333
333333333333333333333333333333333333333333333000000000000000000000033333300033333333333333333333333333333333333333333333333
333333333333333333333333333333333333333333333000000000000000000000033333333333333333333333333333333333333333333333333333333
333333333333333333333333333333333333333333333000000000000000000000033333333333333333333333333333333333333333333333333333333
333333333333333333333333333333333333333333333000000000000300000000033333333333333333333333333333333333333333333333333333333
333333333333333333333333333333333333333333333000000000003330000000033333333333333333333333333333333333333333333333333333333
333333333333333333333333333333333333333333333300000000033330000000333333333333333333333333333333333333333333333333333333333
333333333333333333333333333333333333333333333300000000333330000003333333333333333333333333333333333333333333333333333333333
333333333333333333333333333333333333333333333330000000333333000333333333333333333333333333333333333333333333333333333333333
333333333333333333333333333333333333333333333333000000333333033333333333333333333333333333333333333333333333333333333333333
333333333333333333333333333333333333333333333333300000333333333333333333333333333333333333333333333333333333333333333333333
333333333333333333333333333333333333333333333333300000333333333333333333333333333333333333333333333333333333333333333333333
333333333333333333333333333333333333333333333333330003333333333333333333333333333333333333333333333333333333333333333333333
333333333333333333333333333333333333333333333333333003333333333333333333333333333333333333333333333333333333333333333333333
333333333333333333333333333333333333333333333333333333333333333333333333333333333333333333333333333333333333333333333333333
333333333333333333333333333333333333333333333333333333333333333333333333333333333333333333333333333333333333333333333333333
333333333333333333333333333333333333333333333333333333333333333333333333333333333333333333333333333333333333333333333333333
333333333333333333333333333333333333333333333333333333333333333333333333333333333333333333333333333333333333333333333333333
333333333333333333333333333333333333333333333333333333333333333333333333333333333333333333333333333333333333333333333333333
333333333333333333333333333333333333333333333333333333333333333333333333333333333333333333333333333333333333333333333333333
333333333333333333333333333333333333333333333333333333333333333333333333333333333333333333333333333333333333333333333333333
333333333333333333333333333333333333333333333333333333333333333333333333333333333333333333333333333333333333333333333333333
333333333333333333333333333333333333333333333333333333333333333333333333333333333333333333333333333333333333333333333333333
333333333333333333333333333333333333333333333333300033333333333333333333333333333333333333333333333333333333333333333333333
333333333333333333333333333333333333333333333333333333333333333333333333333333333333333333333333333333333333333333333333333
333333333333333333333333333333333333333333333333333333333333333333333333333333333333333333333333333333333333333333333333333
333333333333333333333333333333333333333333333333333333333333333333333333333333333333333333333333333333333333333333333333333
54 50
118 123