000000000000000000000000000000000000000000000000000000000330000000000000000000000000000000000000000000000000000000000000000
000000000000000000000000000000000000000000000000000000000000000000000000000000000000000000000000000000000000000000000000000
000000000000000000000000000000000000000000000000000000000000000000000000000000000000000000000000000000000000000000000000000
000000000000000000000000000000000000000000000000000000000003300000000000000000000000000000000000000000000000000000000000000
000000000000000000000000000000000000000000000000000000000033300000000000000000000000000000000000000000000000000000000000000
000000000000000000000000000000000000000000000000000000000033330000000000000000000000000000000000000000000000000000000000000
000000000000000000000000000000000000000000000000000000000333330000000033000000000000000000000000000000000000000000000000000
000000000000000000000000000000000000000000000000000000000333330000000333000000000000000000000000000000000000000000000000000
000000000000000000000000000000000000000000000000000000003333330000003333000000000000000000000000000000000000000000000000000
000000000000000000000000000000000000000000000000000000000333330000003333000000000000000000000000000000000000000000000000000
000000000000000000000000000000000000000000000000000000000333330000033330000000000000000000000000000000000000000000000000000
000000000000000000000000000000000000000000000000000000003333333000033330000000000000000000000000000000000000000000000000000
000000000000000000000000000000000000000000000000000000333333333333333333000000000000003000000000000000000000000000000000000
000000000000000000000000000000000000000000000000000000333333333333333333000000000000033300000000000000000000000000000000000
000000000000000000000000000000000000000000000000003033333333333333333333000000000000003330333000000000000000000000000000000
000000000000000000000000000000000000000000000000003333333333333333333333000000000000003333333300000000000000000000000000000
000000000000000000000000000000000000000000000000003333333333333333333333000000000000003333333300000000000000000000000000000
000000000000000000000000000000000000000000000000003333333333333333333333000000000000003333333330000000000000000000000000000
000000000000000000000000000000000000000000000000003333333333333333333330000000000000033333333330000000000000000000000000000
000000000000000000000000000000000000000000000000003333333333333333333300000000000000033333333330000000000000000000000000000
000000000000000000000000000000000000000000000000003333333333333333333300000000000000003333333333000000000000000000000000000
000000000000000000000000000000000000000003333333333333333333333333333000000000000000003333333333000000000000000000000000000
000000000000000000000000000000000000000333333333333333333333333333333000000000000000000333333333300000000000000000000000000
000000000000000000000000000000000000000333333333333333333333333333333000000000003000000333333333330000000000000000000000000
000000000000000000000000000000000000003333333333333333333333333333333300000000003300000333333333333000000000000000000000000
000000000000000000000000000000000003033333333333333333333333333333333333000000333330000333333333333333000000000000000000000
000000000000000000000000000000000033333333333333333333333333333333333333330000003300000033333333333333000000000000000000000
000000000000000000033300000000000333333333333333333333333333333333333333330000030000000003333333333333000000000000000000000
000000000000000000033330000000003333333333333333333333333333333333333333330000000000000003333333333333300000000000000000000
000000000000000000000333300000033333333333333333333333333333333333333333300000033330000000033333333333300000000000000000000
000000000000000000000033300000333333333333333333333333333333333333333333300003333300000000003333333333300000000000000000000
000000000000000000000003330033333333333333333333333333333333333333333333330303333300000000000333333333300000000000000000000
000000000000000000000000003333333333333333333333333333333333333333333333333333333300000000000333333333330000000000000000000
000000000000000000000000003333333333333333333333333333333333333333333333333333333330000000000033333333330000000000000000000
000000000000000000000000033333333333333333333333333333333333333333333333333333333330000000000003333333333000000000000000000
000000000000000000000000033333333333333333333333333333333333333333333333333333333330000000000000033333333300000000000000000
000000000000000000000000333333333333333333333333333333333333333333333333333333333330000000000000000333333330000000000000000
000000000000000000000003333333333333333333333333333333333330033333333333333333333330000000000000003333333330000000000000000
000000000000000000000033333333333333333333333333333333333000003333333333333333333330000000000000003333333330000000000000000
333330000000000000000333333333333333333333333333333333330000003333333333333333333330000000000000033333333333000000000000000
333333330000000000033333333333333333333333333333333333333000003333333333333333333300000000000000030333333333000000000000000
333333333330000000033333333333333333333333333333333333333000033333333333333333333300000000000000000003333333000000000000000
033333333333300003333333333333333333333333333333333333333333333333333333333333333000000000300000000000333333300000000000000
033333333333333333333333333333333333333333333333333333333333333333333333333333333000000003333000000000333333330000000000000
033333333333333333333333333333333333333333333333333333333333333333333333333333333000000003333000000000033333330000000000000
000333333333333333333333333333333333333333333333333333333333333333333333333333333333000000330000000000033333330000000000000
000033333333333333333333333333333333333333333333333333333333333000000033333333333333300000000000000000003333333000000000000
000003333333333333333333333333333333333333333333333333333333300000000000333333333333333000000000000000000333333000000000000
000000333333333333333030300000033333333333333333333333333333000000000000333333333333333300000000000000003333333000000000000
000000033333333333330000000000033333333333333333333333333333300000000000033333333333333300000000000000003333333000000000000
000000003333333333300000000000003333333333333333333333333333330000000000033333333333333000000000000000033333333000000000000
000000000333333333300000000000003333333333333333333333333333330030000000033333333333300000000000000000333333330000000000000
000000003333333333300000000000003333333333333333333333333333330030000000003333333333300000000000000000333333000000000000000
000000033333333333330000000000003333333333333333333333333003333333000000000333333333300000000000000003333330000000000000000
000000033333333333330000000000000333333333333333333333333000033333300000000003333333330000000000000003333000000000000000000
000000333333333333300000000000000033333333333333333333330000033333300000000000333333330000000000000033330000000000000000000
000000333333333333300000000000000033333333333333333333300000033333300000000000003333330000000000000333330000000000000000000
000000333333333333000000000000000033333333333333333333300000000333300000000000003333333000000000003333330000000000000300003
000000033333333333300000000000000333333333333333333333330000000000000000000000000333330000000000003333333000000000003333333
000000000333333333330000000000000333333333333333333333333000000000000000000000000333333000000000033333333333000000003333330
000000000000033333333000000030033333333333333333333333333000000000000000000000000033330000000000333333333300000000033333300
000000000000033333333330000000333333333333333333333333333000000000000000000000000003300000000003333333330000000003333330000
000000000000003333333333300000333333333333333333333333333000000000000000000000000000000000000003333333300000000333333330000
000000000000033333333333300000333333333333333333333333333000000000000000000000000000000000000033333333330033333333333330000
000000000000003333333330000000033333333333333333333333330000000000000000000000000000000000000033333333330003333333333333000
000000000000003333333330000000000333333333333333333333333000000000000000000000000000000000000333333333333303333333333333030
000000000000000333333333000000000000033333333333333333333300000000000000000000000000000000000333333333333333333333333330000
000000000000000033333333300000000000000000333333333333333300000000000000000000000000000000000333333333333333333333333300000
000000000000000033333333300000000000000000033333333333333330300000000000000000000000000000000003333303333333333333333000000
000000000000000033333333300000000000000000003333333333333330000000000000000000000000000000000000000000333333333333300000000
000000000000000033333333000000000000000000000333333303333300000000000000000000000000000000000000000000333333333333300000000
000000000000000003333333300000000000000000000333333000333330000000000000000000000000000000000000000003333333333330000000000
000000000000000000333333330000000000000000003333333000033300000000000000000000000000000000000000000333333333333300000000000
000000000000000000000333330000000000000000003333333000033330000000000000000000003333300000000000003333333333333000000000000
000000000000000000000033333000000000000000003333333000333333000000000000000000333333333000000000333333333333300000000000000
000000000000000000000003333300000000000000003333333303333333330000000000000003333333333300000033333333333333000000000000000
000000000000000000000000033300000000000000003333333333333333333000000003333333333333003300003333333333333000000000000000000
000000000000000000000000033330000000000000003333333333333333333000000033333333333300000000003333333333300000000000000000000
000000000000000000000000003330000000000000003333333333333333333000000333333333333300000000333333333333000000000000000000000
000000000000000000000000003330000000000000033333333333333333333000003333333333333330000000333333333330000000000000000000000
000000000000000000000000000333000000000000033333333333333333333000033333333333333333000000333333333300000000000000000000000
000000000000000000000000000333000000000000033333333333333333033000033333333333333333330003333333333000000000000000000000000
000000000000000000000000000333333000000000033333333333333300000000033333333333333333333333333330000000000000000000000000000
000000000000000000000000000033333333000000003333333333330000000000033333333333333333333333333330000000000000000000000000000
000000000000000000000000000003333333330000003333300000000000000000033333333333333330033333333333000000000000000000000000000
000000000000000000000000000000033333330000033333300000000000000000003333333333333330000333333333000000000000000000000000000
000000000000000000000000000000033333333000333330000000000000000000003333333333333330000003300330000000000000000000000000000
000000000000000000000000000000003333333300333300000000000000000000003333333333333333000000000000000000000000000000000000000
000000000000000000000000000000003033333300333300000000000000000000003333333333333333000000000000000000000000000000000000000
000000000000000000000000000000000033333303333300000000000000000000003333333333333333300000000000000000000000000000000000000
000000000000000000000000000000030333333333333300000000000000000000003333333333333333330000000000000000000000000000000000000
000000000000000000000000000000000333333333333000000000000000000000033333330333333333330000000000000000000000000000000000000
000000000000000000000000000000000033333333333000000000000000000000033333300033333333330000000000000000000000000000000000000
000000000000000000000000000000000003333333333000000000000000000000033333333333333333330000000000000000000000000000000000000
000000000000000000000000000000000003333333333000000000000000000000033333333333333303333000000000000000000000000000000000000
000000000000000000000000000000000033333333333000000000000300000000033333333333300000000000000000000000000000000000000000000
000000000000000000000000000000000003333333333000000000003330000000033333333333000000000000000000000000000000000000000000000
000000000000000000000000000000000003333333333300000000033330000000333333333300000000000000000000000000000000000000000000000
000000000000000000000000000000000000033333333300000000333330000003333333333300000000000000000000000000000000000000000000000
000000000000000000000000000000000000003333333330000000333333000333333333333300000000000000000000000000000000000000000000000
000000000000000000000000000000000000000333333333000000333333033333333333333300000000000000000000000000000000000000000000000
000000000000000000000000000000000000000333333333300000333333333333333333333000000000000000000000000000000000000000000000000
000000000000000000000000000000000000000003333333300000333333333333333333300000000000000000000000000000000000000000000000000
000000000000000000000000000000000000000003333333330003333333333333333333000000000000000000000000000000000000000000000000000
000000000000000000000000000000000000000000333333333003333333333333333300000000000000000000000000000000000000000000000000000
000000000000000000000000000000000000000000333333333333333333333333300000000000000000000000000000000000000000000000000000000
000000000000000000000000000000000000000000333333333333333333333330000000000000000000000000000000000000000000000000000000000
000000000000000000000000000000000000000000333333333333333333333300000000000000000000000000000000000000000000000000000000000
000000000000000000000000000000000000000000033333333333333333333300000000000000000000000000000000000000000000000000000000000
000000000000000000000000000000000000000000003333333333333333333000000000000000000000000000000000000000000000000000000000000
000000000000000000000000000000000000000000003333333333333333330000000000000000000000000000000000000000000000000000000000000
000000000000000000000000000000000000000000000333333333333333330000000000000000000000000000000000000000000000000000000000000
000000000000000000000000000000000000000000000033333333333333300000000000000000000000000000000000000000000000000000000000000
000000000000000000000000000000000000000000000003333333333033300000000000000000000000000000000000000000000000000000000000000
000000000000000000000000000000000000000000000000300003000000000000000000000000000000000000000000000000000000000000000000000
000000000000000000000000000000000000000000000000000000000000000000000000000000000000000000000000000000000000000000000000000
000000000000000000000000000000000000000000000000033300000003000000000000000000000000000000000000000000000000000000000000000
000000000000000000000000000000000000000000000000003000000000000000000000000000000000000000000000000000000000000000000000000
54 50
118 123