00000000000000000000000000000000000000000000000000000330003000000000000000000000000000000000000000000000000
00000000000000000000000000000000000000000000000000000330030000000000003300000000000000000000000000000000000
00000000000000000000000000000000000000000000000000003330333300000000003000000000000000000000000000000000000
00000000000000000000000000000000000000000000000000003303333300000000003000000000000000000000000000000000000
00000000000000000000000000000000000000000000000000003333333300000000333000000000000000000000000000000000000
00000000000000000000000000000000000000000000000000033333333330000000330000000000000000000000000000000000000
00000000000000000000000000000000000000000000000000033303333330000003330000000000000000000000000000000000000
00000000000000000000000000000000000000000000000000033333333300000003330000000000000000000000000000000000000
00000000000000000000000000000000000000000000000000033333333300003033330000000000000300000000000000000000000
00000000000000000000000000000000000000000000000000033333333300003333300000000000000330000000000000000000000
00000000000000000333000000000000000000000000000000033333333300033333300000000000000030000000000000000000000
00000000000000000333330000000000000000000000000000033333333300033333333000000000000330000000000000000000000
00000000000000000003333000000000000000000000000000003333333330333333333000000000000330000000000000000000000
00000000000000000003033000000000000000000000000000003333333333333333333000000000000300000000000000000000000
00000000000000000000333300000000000000000000000033033333333333333333333000000000003000000000000000000000000
00000000000000000000033000000000000000000000000033333333333333333333330000000000003000000000000000000000000
00000000000000000033003000000000000000000000000033333333333333333333300000000000003000000000000000000000000
00000000000000000333000000000000000000000000000003333333333333333333300000000000030000000000000000000000000
00000000000000000000000000000000000000000000000003333333333333333333300000000003030000000000000000000000000
00000000000000000000000000000000000000000000000003333333333333333333000000000033300000000000000000000000000
00000000000000000000000000000000000000000000000000333333333333333330000000000003300000000000000000000000000
00000000000000000000000000000000000000033000000000333333333333333330000000000000000000000000000000000000000
00000000000000000000000000000000000000000000000003333333333333333330000300030000000000000000000000000000000
00000000000000000000000000000000000000000000033333333333333333333333000300033033330000000000000000000000000
00000000000000000000000000000000000000000000033333333333333333333333033033033033330000000000000000000000000
00000000000000000030000000000000000000000000003333333333333333333333033333333003300000000000000000000000000
00000000000000000330000000000003000000000000000333333333333333333333333000330033300000000000000000000000000
00000000000000000333300000000033333000000000000333333333330333333333333000300033000000000000000000000000000
00000000000000000033330000030033033000000000000333333333300333333333333000000003300000000000000000000000000
00000000000000000003330000000003000303000000333333333333300033333333333000000333300000000000000000000000000
00000000000000000000333033333330000033000000333333333333300033333333330033003333300000000000000000000000000
00000000000000000000003330303330000003000000333333333333000003333333333033033333000000000000000000000000000
00000000000000000000000033333330000333330003333333333330000033333333333333333330000000000000000000000000000
00000000000000000000000033333333000033333333333300333333000033333333333333333300000000000000000000000000000
00000000000000000000000333333333300033333333333300333333000000033333333333333300000000000000000000000000000
00000000000000000000000033333333333333333333333300333003300000033333333333333000000000000000000000000000000
00000000000000000000000033333333333333333333333333333303000000003333333333300000000000000000000000000000000
00000000000000000000000003333330333333333333333333033300000000000333333333300000000000000000000000000000000
00000000000000000000000000333333033333333333333333033330030000000333333333300000000000000000000000000000000
00000000000000000000000000333333033333333333333333333330330000000033333333000000000000000000000000000000000
30003000000000000000000000003333333330033333333333330330033000000033333333000000000000000000000000000000000
30030300000000000000000000000333333300003333333303330033333303000033333300000000000000000000000000000000000
03333000333333333333300000000333333333003333333330330033033333030000333033000000000000000000000000000000000
03333000333333333333333000003333333333333333333333333033333333333000033030000000000000000000000000000000000
33333333333333333333333333333333333333333333333333333330033333333000033000000000000000000000000000000000000
00033333333333333333300033333333333333333333333333333330333030030000000000000000000000000000000000000000000
00000000003333330003333000333333333333333333333333033333330000000000000000000000000000000000000000000000000
00000000000033333000033000003033333333333333333330003333330000000000000000000000000000000000000000000000000
00000000000003333300000000033333333333333033330333000333000000000000000000000000000000000000000000000000000
00000000333333330000000000000333333333333330000333300000330000000000000000000000000000000000000000000000000
00000000033333300000000000000000300333333330000033000000333000000003000000000000000000000000000000000000000
00000000003333330003000000000000003333333333300033300000333300300003000000000000000000000000000000000000000
00000000003333300033300000000000000333333333300003330000003303330003000000000000000000000000000000000033000
00000000000330000000000000000000000003333333330000000000000000030000000000000000000000000000000000000330000
00000000000333300000000000000000000003333333333000000000000000000000000000000000000000000000000000003000000
00000000000003300000000000030300000000033333333300000000000000000000000000000000000000000000000000333300000
00000000000003333000000000003000000000000033333333000000000000000000000000000000000000000000000000033000000
00000000000000333000000000000000000000000000003333333300000000000000000000000000000000000000000000003300000
00000000000000033330000000000000000000000000000003333300000000000000000000000000000000000000000000333300000
00000000000000003330000000000000000000000000000033333300000000000000000000000000000000000000000003330000000
00000000000000000333333000000000000000000000000033333300000000000000000000000000000000000000000000000000000
00000000000000000033333330000000000000000000000003333300000000000000000000000000000000000000000000000000000
00000000000000000033300000000000000000000000003003333033000000000000000000000000000000000000000000000000000
00000000000000000000000000000000000000000333333303330030000000000000000000000000000000000000000000000000000
00000000000000000000000000000000000003333333330000330030000000000000000000000000000000000000000000000000000
00000000000000000000000000000000000033333333333000030333000000000000000000000000000000000000000000000000000
00000000000000000000000000000000000000003333300000003033003000000000000000000000000000000000000000000000000
00000000000000000000000000000000000003333333300000000033003300000000000000000000000000000000000000000303330
00000000000000000000000000000000003333300030300000000033000300000000000000000000000000000000000000000033333
00000000000000000000000000000000003000000000300000000033000000000000000000000000000000000000000000000333330
00000000000000000000000000000000000000000000300030000033300000000000000000000000000000000000000000033300000
00000000000000000000000000000000000000000003003330000000300000000000000000000000000000000000000000000000000
00000000000000000000000000000000000000000003333330000000000000000000000000000000030030000000000000000000000
00000000000000000000000000000000000000000000033030000000000000000000000000000003333330000000000000000000000
00000000000000000000000000000000000000000030033030000000000000000000000000000333300333000000000000000000000
00000000000000000000000000000000000000000030033030000000000000000000303330003333000000300030000000000000000
00000000000000000000000000000000000000000333033030000000000000003000333333333303000000000303000000000000000
00000000000000000000000003000000000000000033330030000000000000033000333303333300000000000333000000000000000
00000000000000000000000000000000000000000330030330000000000000003333333000330000000000000003300000000000000
00000000000000000000000000000000000000000330000030000000000000000333333000000000000000000000030000000000000
00000000000000000000000000000000000000000330300030000000000000003300030000000000000000000000000000000000000
00000000000000000000000000000000000000000330300000000000000000003300033000000000000000000000000000000000000
00000000000000000000000000000000000000000303300000000000000000000330000000000000000000000000000000000000000
00000000000000000000000000000000000000000303300000000000000000000033000000000000000000000000000000000000000
00000000000000000000000000000000000330003333300000000000000000300030000000000000000000000000000000000000000
00000000000000000000000000000000000330003333000000000000000000030000000000000000000000000000000000000000000
00000000000000000000000000000000000300003333000000000000000000033000000000000000000000000000000000000000000
00000000000000000000000000000000003300003333000000000000000000003000300000000000000000000000000000000000000
00000000000000000000000000000000003300033333000000000000000000003300300000000000000000000000000000000000000
00000000000000000000000000000000033000033333000000000000000000003330330000000000000000000000000000000000000
00000000000000000000000000000000030000033333000000000000000000003330330000000000000000000000000000000000000
00000000000000000000000000000000330000033330000000000000000000000333330000000000000000000000000000000000000
00000000000000000000000000000000000000333330000000000000000000000333333000000000000000000000000000000000000
00000000000000000000000000000000000000333330000000000000000000000033333000000000000000000000000000000000000
00000000000000000000000000000000000000033330000000000000000000000033333300000000000000000000000000000000000
00000000000000000000000000000000000000003300000000000000000000000033333300000000000000000000000000000000000
00000000000000000000000000000000000000000300033300000000000000000003333300000000000000000000000000000000000
00000000000000000000000000000000000000000000003000000000000000000003333330000000000000000000000000000000000
00000000000000000000000000000000000000000003333000000000000000000000300330000000000000000000000000000000000
00000000000000000000000000000000000000000003333000000000000000000000330030000000000000000000000000000000000
00000000000000000000000000000000000000000003300000000000000000330000000000000000000000000000000000000000000
00000000000000000000000000000000000000000003300000000000000000300000030000000000000000000000000000000000000
00000000000000000000000000000000000000000000330000000000000033300000330000000000000000000000000000000000000
00000000000000000000000000000000000000000000333300000000000000000000000000000000000000000000000000000000000
53 48
104 107