00000000000000000000000000000000000000000000000000000330003000000000000000000000000000000000000000000000000
00000000000000000000000000000000000000000000000000000000000000000000000000000000000000000000000000000000000
00000000000000000000000000000000000000000000000000000000000000000000000000000000000000000000000000000000000
00000000000000000000000000000000000000000000000000000000000000000000000000000000000000000000000000000000000
00000000000000000000000000000000000000000000000000000000303000000000000000000000000000000000000000000000000
00000000000000000000000000000000000000000000000000000000333000000000000000000000000000000000000000000000000
00000000000000000000000000000000000000000000000000003000333000000000330000000000000000000000000000000000000
00000000000000000000000000000000000000000000000000000003333000000003300000000000000000000000000000000000000
00000000000000000000000000000000000000000000000000000003333000000003300000000000000000000000000000000000000
00000000000000000000000000000000000000000000000000000003333300000003300000000000000000000000000000000000000
00000000000000000000000000000000000000000000000000000000333300000003300000000000000000000000000000000000000
00000000000000000000000000000000000000000000000000000000333300000033300000000000000000000000000000000000000
00000000000000000000000000000000000000000000000000000000333330033333300000000000000000000000000000000000000
00000000000000000000000000000000000000000000000000000000333333333333300000000000000000000000000000000000000
00000000000000000000000000000000000000000000000000003303333333333333300000000000000000000000000000000000000
00000000000000000000000000000000000000000000000000033333333333333333300000000000000000000000000000000000000
00000000000000000000000000000000000000000000000003333333333333333333300000000000000000000000000000000000000
00000000000000000000000000000000000000000000000003333333333333333333000000000000000000000000000000000000000
00000000000000000000000000000000000000000000000003333333333333333330000000000000000000000000000000000000000
00000000000000000000000000000000000000000000000003333333333333333330000000000000000000000000000000000000000
00000000000000000000000000000000000000000000000000333333333333333330000000000000000000000000000000000000000
00000000000000000000000000000000000000000000000000333333333333333330000000000000000000000000000000000000000
00000000000000000000000000000000000000000000000003333333333333333300000000000000000000000000000000000000000
00000000000000000000000000000000000000000000000033333333333333333330000000000000000000000000000000000000000
00000000000000000000000000000000000000000000000333333333333333333333000000000000000000000000000000000000000
00000000000000000000000000000000000000000000000333333333333333333333000000000000000000000000000000000000000
00000000000000000000000000000000000000000000000333333333333333333333330000000000000000000000000000000000000
00000000000000000000000000000000000000000000000333333333333333333333330000000000000000000000000000000000000
00000000000000000000000000000000000000000000003333333333300333333333330000000000000000000000000000000000000
00000000000000000000000000000000000000000000033333333333300033333333330000000000000000000000000000000000000
00000000000000000000000000000000000000000000033333333333000033333333330000000000000000000000000000000000000
00000000000000000000000000000000000000000000333333333330000003333333330000000000000000000000000000000000000
00000000000000000000000000000000000000000000333333333330000000333333333000000000000000000000000000000000000
00000000000000000000000000000000000000333003333300333330000000333333333333000000000000000000000000000000000
00000000000000000000000000000000000003333333333300333330000000033333333333300000000000000000000000000000000
00000000000000000000000000000000333333333333333333333300000000033333333333300000000000000000000000000000000
00000000000000000000000000033300333333333333333333333300000000003333333333000000000000000000000000000000000
00000000000000000000000000033330033333333333333333033300000000000333333330000000000000000000000000000000000
00000000000000000000000000033333033333333333333330003300000000000033333333000000000000000000000000000000000
00000000000000000000000000033333333333333333333333000000000000000033333330000000000000000000000000000000000
30000000000000000000000000003333333330033333333333000000000000000003333300000000000000000000000000000000000
30000000000000000000000000000333333300003333333330000000000000000003333300000000000000000000000000000000000
00000000000000000000000000000333333330003333333333000000000000000000333000000000000000000000000000000000000
00000000003333300033300000000333333333003333333333300000000330000000000000000000000000000000000000000000000
30000000003333330000000003333333333333333333333333333300003330000000000000000000000000000000000000000000000
00000000003333300000000000333333333333333333333333333330333000000000000000000000000000000000000000000000000
00000000000333300000000000033333333333333333333333033333330000000000000000000000000000000000000000000000000
00000000000033330000000000000000003333333333333300000333300000000000000000000000000000000000000000000000000
00000000000003300000000000000000000333333333330000000030000000000000000000000000000000000000000000000000000
00000000000003000000000000000000000333333333000000000000000000000000000000000000000000000000000000000000000
00000000000030000000000000000000000333333333000000000000000000000000000000000000000000000000000000000000000
00000000000330000000000000000000000333333333300000000000000000000000000000000000000000000000000000000000000
00000000000000000000000000000000000033333333300000000000000000000000000000000000000000000000000000000000000
00000000000000000000000000000000000003333333330000000000000000000000000000000000000000000000000000000000000
00000000000000000000000000000000000000033333330000000000000000000000000000000000000000000000000000000000000
00000000000000000000000000000000000000000333333300000000000000000000000000000000000000000000000000000000000
00000000000000000000000000000000000000000003333300000000000000000000000000000000000000000000000000000000000
00000000000000000000000000000000000000000000000000030000000000000000000000000000000000000000000000000000000
00000000000000000000000000000000000000000000000000333000000000000000000000000000000000000000000000000000000
00000000000000000000000000000000000000000000000003330000000000000000000000000000000000000000000000000000000
00000000000000000000000000000000000000000000000000000000000000000000000000000000000000000000000000000000000
00000000000000000000000000000000000000000000000000000000000000000000000000000000000000000000000000000000000
00000000000000000000000000000000000000000000000003300000000000000000000000000000000000000000000000000000000
00000000000000000000000000000000000000000000000003330000000000000000000000000000000000000000000000000000000
00000000000000000000000000000000000000333330300000300030000000000000000000000000000000000000000000000000000
00000000000000000000000000000000000000033333330000000030000000000000000000000000000000000000000000000000000
00000000000000000000000000000000000000003333300000000033000000000000000000000000000000000000000000000000000
00000000000000000000000000000000000000000000000000000033000000000000000000000000000000000000000000000000030
00000000000000000000000000000000000000000000000000000033000000000000000000000000000000000000000000000000033
00000000000000000000000000000000000000000000000000000003000000000000000000000000000000000000000000000000030
00000000000000000000000000000000000000000000000000000000000000000000000000000000000000000000000000000000000
00000000000000000000000000000000000000000000000330000000000000000000000000000000000000000000000000000000000
00000000000000000000000000000000000000000000003330000000000000000000000000000000000000000000000000000000000
00000000000000000000000000000000000000000000033330000000000000000000000000000000000000000000000000000000000
00000000000000000000000000000000000000000000033300000000000000000000000000000033000000000000000000000000000
00000000000000000000000000000000000000000000033000000000000000000000000000003330000000000000000000000000000
00000000000000000000000000000000000000000000000000000000000000000000003000000000000000000000000000000000000
00000000000000000000000000000000000000000000000000000000000000000000030000000000000000000000000000000000000
00000000000000000000000000000000000000000000000000000000000000000000000000000000000000000000000000000000000
00000000000000000000000000000000000000000000000000000000000000000000000000000000000000000000000000000000000
00000000000000000000000000000000000000000000000000000000000000000000000000000000000000000000000000000000000
00000000000000000000000000000000000000000000000000000000000000000000000000000000000000000000000000000000000
00000000000000000000000000000000000000000000000000000000000000000000000000000000000000000000000000000000000
00000000000000000000000000000000000000000000000000000000000000000000000000000000000000000000000000000000000
00000000000000000000000000000000000000000000000000000000000000000000000000000000000000000000000000000000000
00000000000000000000000000000000000000000000000000000000000000000000000000000000000000000000000000000000000
00000000000000000000000000000000000000000000000000000000000000000000000000000000000000000000000000000000000
00000000000000000000000000000000000000000000000000000000000000000000000000000000000000000000000000000000000
00000000000000000000000000000000000000000000000000000000000000000000000000000000000000000000000000000000000
00000000000000000000000000000000000000003300000000000000000000000000000000000000000000000000000000000000000
00000000000000000000000000000000000000033330000000000000000000000000000000000000000000000000000000000000000
00000000000000000000000000000000000000033330000000000000000000000000000000000000000000000000000000000000000
00000000000000000000000000000000000000033330000000000000000000000000000000000000000000000000000000000000000
00000000000000000000000000000000000000033330000000000000000000000000000000000000000000000000000000000000000
00000000000000000000000000000000000000033330000000000000000000000000030000000000000000000000000000000000000
00000000000000000000000000000000000000000000000000000000000000000000033000000000000000000000000000000000000
00000000000000000000000000000000000000000000000000000000000000000000033000000000000000000000000000000000000
00000000000000000000000000000000000000000000000000000000000000000000000000000000000000000000000000000000000
00000000000000000000000000000000000000000000000000000000000000000000000000000000000000000000000000000000000
00000000000000000000000000000000000000000000000000000000000000000000000000000000000000000000000000000000000
00000000000000000000000000000000000000000000000000000000000000000000000000000000000000000000000000000000000
00000000000000000000000000000000000000000000000000000000000000000000000000000000000000000000000000000000000
00000000000000000000000000000000000000000000330000000000000033300000330000000000000000000000000000000000000
00000000000000000000000000000000000000000000333300000000000000000000000000000000000000000000000000000000000
53 48
104 107