000000000000000000000000000000000000000000000000000000000330000000000000000000000000000000000000000000000000000000000000000
000000000000000000000000000000000000000000000000000000033330300000000000000000000000000000000000000000000000000000000000000
000000000000000000000000000000000000000000000000000000333333333000000000030000300030000000000000000000000000000000000000000
000000000000000000000000000000000000000000000000000000333033333000000000300000303330000000000000000000000000000000000000000
000000000000000000000000000000000000000000000000000000330333333000000000300030333300000000000000000000000000000000000000000
000000000000000000000000000000000000000000000000000000333333333000000033303303333300000000000000000000000000000000000000000
000000000000000000000000000000000000000000000000000003333333333000000333003300000300000000000000000000000000000000000000000
000000000000000000000000000000000000000000000000000003333333333000003333033300000000000000000000000000000000000000000000000
000000000000000000000000000000000000000000000000000003333333330000003333033000000033300000000000000000000000000000000000000
000000000000000000000000000000000000000000000000000003333333330000303333000000003333333333000000000000000000000000000000000
000000000000000000000000000000000000000000000000000003333333330000333333000000003333333333300000000000000000000000000000000
000000000000000000033000000000000000000000000000000003333333333303333330000000003303333333000000000000000000000000000000000
000000000000000000033333000000000000000000000000033003333333333333333333300000003303333333033330000000000000000000000000000
000000000000000000003333300000000000000000000000033303333333333333333333300000003303333330333300000000000000000000000000000
000000000000003300033333300000000000000000000000033333333333333333333333300000003000033333333333000000000000000000000000000
000000000000033333333333330000000000000000000000033333333333333333333333300000033000333333333333000000000000000000000000000
000000000000033333003303300000000000000000000000033333333333333333333333300000030003333333333330000000000000000000000000000
000000000000333333333300300000000000000000000000033333333333333333333333003000330000333333333333000000000000000000000000000
000000000000333333333330300000000000000003000000033333333333333333333333033003300003333333333333000000000000000000000000000
000000000000303333333330000000000000000003333000033333333333333333333330033000300303333333333333000000000000000000000000000
000000000000303333333330000000000000030033333003003333333333333333333300030000003333333333333333300000000000000000000000000
000000000000333333333330000000000000033333333333303333333333333333333000030000033330003333333333330000000000000000000000000
000000000000033333333333000000000000033333333333333333333333333333333000000000033333033333333333333000000000000000000000000
000000000000333333333333000000000003333333333333333333333333333333333330030003333333033333333333333300300000000000000000000
000000000000033333333333300000000033333333333333333333333333333333333330030003333333003333333333330303300000000000000000000
000000000000003333333333330000000333333333333333333333333333333333333333333003333333033333333333333333333000000000000000000
000000000000000333333333330000000333333333333333333333333333333333333333333333333330003333333333333333330000000000000000000
000000000000000033333333333000033333333333333333333333333333333333333333333033333330000303333333333333330000000000000000000
000000000000000000333333330000333333333333333333333333333333333333333333333033333330003033333333333333300000000000000000000
000000000000000000033333333333333333333333333333333333333333333333333333333003333333000033303333333333300000000000000000000
000000000000000000000333333333333333333333333333333333333333333333333333333003333333000033333333333333300000000000000000000
000000000000000000000033333333333333333333333333333333333333333333333333333333333333300000033333333333330000000000000000000
000000000000000000000003333333333333333333333333333333333333333333333333333333333333330000033333333333333000000000000000000
000000000000000000000000033333333333333333333333333333333333333333333333333333333333300000033333333333333330000000000000000
000000000000000000000000333333333333333333333333333333333303333333333333333333333333300000033333333333333333000000000000000
000000000000000000000000333333333333333333333333333333333303333333333333333333333333300000000333333333333333000000000000000
000000000000000000000000333333333333333333333333333333300333333333333333333333333333000000000333300333333333000000000000000
030000000000000030033033333333333333333333333333333333330330333333333333333333333333000000003333333333333333000000000000000
033300000000000030033333333333333333333333333333333333330000033333333333333333333333000003033333333333333333003300000000000
333330000000000333333333333333333333333333333333333333330003033333333333333333333330300033033333333333333333333330000000000
333333333030000333333333333333333333333333333333333333333003033333333333333333333300300330033333333333333333333000000000000
333333333333330000333333333333333333333333333333333333333033333333333333333333333303300030333303333033333333330000000000000
033333333333333303333333333333333333333333333333333333333333333333333333333333333303003303333333030030333333330000000000000
033333333333333333333333333333333333333333333333333333333333333333333333333333333033303333333330300003333333330000000000000
033333333333333333333333333333333333333333333333333333333333333333333333333333333333333333333300000003333333333000000000000
033333333333333333333333333333333333333333333333333333333333333333333333333033333333333333333000000030033333333000000000000
003333333333333333333333333333333333333333333333333333333333333003333333333333333333333333330000000000003333333000000000000
000333333333333333333333333333333333333333333333333333333333303300000033333333333333333333300000000000033333333000000000000
000333333333333333303333333000333333333333333333333333333333000000030000333333333333333333300000000000003333333000000000000
000000333333333333330003000033333333333333333333333333333333333030033000033333333333333333000000000000033333333300000000000
000000033333333333300003333033033333333333333333333333333333333333030000033333333333333330000000000000333333333000000000000
000000000333333333300000000003033333333333333333333333333333330033000300033333333333333300000000000003333333330000000000000
000000003333333333333000000003333333333333333333333333330033330033000303003333333333333000000000000033333333000000000000000
000000033333333333333333000303333333333333333333333333333003333333300333000333333333333000000000000033333330000000000000000
000000033333333333333300030300033333333333333333333333333000333333300030000003333333333000000000000033333000000000000000000
000000333333333333333300033330333333333333333333333333333300033333300000000003333333333000000000000333330000000000000000000
000003333333333333300000000303333333333333333333333333333330333333330033000000333333333000003000000333330000000000000000000
000000333333333333000000000000333333333333333333333333333330333333333333000000003333333300330000003333330000000000033333003
000000333333333333330000000000000333333333333333333333333333033333000003000000000333333003300000003333330000003333333333333
000000003333333333333330000000333333333333333333333333333330033330000000000000000333333330000000003333333333333333333333330
000000000000033333333333000033333333333333333333333333333000000000000000000000000033333000000000333333333333333303033333300
000000000000033333333333033333333333333333333333333333333000000000000000000000000033300000000003333333333333333003333333000
000000000000003333333333333330333333333333333333333333333000000000000000000000000003300000000003333333333033333333333330000
000000000000033333333333333333333333333333333333333333333000000000000000000000000000000000000033333333333333333333333303000
000000000000033333333330333333333033333333333333333333333300000000000000000000000000000000000033333333333333333333333333300
000000000000333333333333333333303333333333333333333333333300300000000000000000000000000000003333333333333333333333333333330
000000000000033333333333333300003300033333333333333333333330330000000000000000000000000000003333333333333333333333333333300
000000000000033333333333333000000000033030033333333333333333330000000000000000000000000000003333333333333333333333333330000
000000000000033333333333300000000000030333333333333333333333330000000000000000000000000000000333333333333333333333333300000
000000000000003333333333300000000000333333003333333033333333330000000000000000000000000000000000000003333333333333330000000
000000000000000333333333300300000000300000033033333003333333300000000000000000003000000000000000000000033333333333300000000
000000000000000333333333003300000000000000033333333000333333300000000000000000003333000000000000000333333333333333300000000
000000000000000003333333333300000000000000333333333000333330330000000000000300033333300000000000000333333333333333000000000
000000000000000000000333333000000000000000333333333003333333030000000000003330333333333000000000033333333333333300000000000
000000000000000000000333333000000000000000303333333303333333030000033300033333333333333330000003333333333333300000000000000
000000000000000000000003333300000000000000303333333333333333330000033330333333333333333303333333333333333333000000000000000
000000000000000000000000333330000000000000003333333333333333333000033333333333333333333333333333333333333000000000000000000
000000000000000000000000033333000000000000003333333333333333333300000333333333333333333333333333333333330000000000000000000
000000000000000000000000003333000000000000033333333333333333333303333333333333333333333333333333333333300000000000000000000
000000000000000000000000003330000000000000033333333333333333333300333333333333333333330033333333333330000000000000000000000
000000000000000000000000000333000000000000033333333333333333333300033333333333333333330003333333333333000000000000000000000
000000000000000000000000000333033330000000033333333333333333033300333333333333333333333333333333333333000000000000000000000
000000000000000000000000000333333330000000033333333333333333003300333333333333333333333333333330330033000000000000000000000
000000000000000000000000000033333333303000033333333333333303000300033333333333333333333333333330000000000000000000000000000
000000000000000000000000000333333333333000033333330033333003330000033333333333333300033333333333000000000000000000000000000
000000000000000000000000003333333333333300333333330033000000333033333333333333333300000333333333300000000000000000000000000
000000000000000000000000033000333333333300333333300000000000333303033333333333333330000033300333300000000000000000000000000
000000000000000000000000030000333333333300333303000000000000333303333333333333333333000000000033300000000000000000000000000
000000000000000000000000000003333333333300333303330000000000333303333333333333333333000000000000000000000000000000000000000
000000000000000000000000000003333333333303333333330000000000030333333333333333333333300000000000000000000000000000000000000
000000000000000000000000000000333333333303333333330000000000030030333333333333333333330000000000000000000000000000000000000
000000000000000000000000000000333333333303333333300000000000000033333333333333333333330000000000000000000000000000000000000
000000000000000000000000000000003333333333333033300000003300000003333333333333333333333000000000000000000000000000000000000
000000000000000000000000000000000033333333333033300000003300030003333333333333333333333000000000000000000000000000000000000
000000000000000000000000000000000333333333333333300000003300003003333333333333333333333000000000000000000000000000000000000
000000000000000000000000000000000033333333333333000000003330000000033333333333333003333000000000000000000000000000000000000
000000000000000000000000000000000033333333333333000000033333000000333333333333003000333000000000000000000000000000000000000
000000000000000000000000000000000033333333333333300000333330300003333333333330000000000000000000000000000000000000000000000
000000000000000000000000000000000033033333333330300000333333333303333333333300000000000000000000000000000000000000000000000
000000000000000000000000000000000000003333333333300000333333033333333333333300000000000000000000000000000000000000000000000
000000000000000000000000000000000000003333333333300000333333033333333333333300000000000000000000000000000000000000000000000
000000000000000000000000000000000000000333333333330000333333333333333333333330000000000000000000000000000000000000000000000
000000000000000000000000000000000000003333333333303003333033033333333333300000000000000000000000000000000000000000000000000
000000000000000000000000000000000000003333333333333303333333333333333333300000000000000000000000000000000000000000000000000
000000000000000000000000000000000000003330333333333333333333333333333330000000000000000000000000000000000000000000000000000
000000000000000000000000000000000000003300333333333333333333333333330300000000000000000000000000000000000000000000000000000
000000000000000000000000000000000000003300333333333333333333333333000000000000000000000000000000000000000000000000000000000
000000000000000000000000000000000000000000333333333333333333333330000000000000000000000000000000000000000000000000000000000
000000000000000000000000000000000000000000033333333333333333333300000000000000000000000000000000000000000000000000000000000
000000000000000000000000000000000000000000003333333333333333333000000000000000000000000000000000000000000000000000000000000
000000000000000000000000000000000000000000033333333333333333333000000000000000000000000000000000000000000000000000000000000
000000000000000000000000000000000000000000033333333333333333330000000000000000000000000000000000000000000000000000000000000
000000000000000000000000000000000000000000033333333333333333330000000000000000000000000000000000000000000000000000000000000
000000000000000000000000000000000000000000030033333333333333300000000000000000000000000000000000000000000000000000000000000
000000000000000000000000000000000000000000000033330333333303300000000000000000000000000000000000000000000000000000000000000
000000000000000000000000000000000000000000000000333330303303000000000000000000000000000000000000000000000000000000000000000
000000000000000000000000000000000000000000000000033300000003000000000000000000000000000000000000000000000000000000000000000
000000000000000000000000000000000000000000000000003000000000000000000000000000000000000000000000000000000000000000000000000
54 50
118 123