333333333333333333333333333333333333333333333333333333333333333333333333333333333333333333333333333333333333333333333333333
333333333333333333333333333333333333333333333333333333333333333333333333333333333333333333333333333333333333333333333333333
333333333333333333333333333333333333333333333333333333333333333333333333333333333333333333333333333333333333333333333333333
333333333333333333333333333333333333333333333333333333333333333333333333333333333333333333333333333333333333333333333333333
333333333333333333333333333333333333333333333333333333333333333333333333333333333333333333333333333333333333333333333333333
333333333333333333333333333333333333333333333333333333333333333333333333333333333333333333333333333333333333333333333333333
333333333333333333333333333333333333333333333333333333333333333333333333333333333333333333333333333333333333333333333333333
333333333333333333333333333333333333333333333333333333333333333333333333333333333333333333333333333333333333333333333333333
333333333333333333333333333333333333333333333333333333333333333333333333333333333333333333333333333333333333333333333333333
333333333333333333333333333333333333333333333333333333333333333333333333333333333333333333333333333333333333333333333333333
333333333333333333333333333333333333333333333333333333333333333333333333333333333333333333333333333333333333333333333333333
333333333333333333333333333333333333333333333333333333333333333333333333333333333333333333333333333333333333333333333333333
333333333333333333333333333333333333333333333333333333333333333333333333333333333333333333333333333333333333333333333333333
333333333333333333333333333333333333333333333333333333333333333333333333333333333333333333333333333333333333333333333333333
333333333333333333333333333333333333333333333333333333333333333333333333333333333333303333333333333333333333333333333333333
333333333333333333333333333333333333333333333333333333333333333333333333333333333333303333333333333333333333333333333333333
333333333333333333333333333333333333333333333333333333333333333333333333333333333333303333333333333333333333333333333333333
333333333333333333333333333333333333333333333333333333333333333333333333333333333333303333333333333333333333333333333333333
333333333333333333333333333333333333333333333333333333333333333333333330333333333333333333333333333333333333333333333333333
333333333333333333333333333333333333333333333333333333333333333333333300333333333333333333333333333333333333333333333333333
333333333333333333333333333333333333333333333333333333333333333333333300333333333333303333333333333333333333333333333333333
333333333333333333333333333333333333333333333333333333333333333333333000333333333333303333333333333333333333333333333333333
333333333333333333333333333333333333333333333333333333333333333333333000333333333333300333333333333333333333333333333333333
333333333333333333333333333333333333333333333333333333333333333333333000333333333333300333333333333333333333333333333333333
333333333333333333333333333333333333333333333333333333333333333333333300333333333333300333333333333333333333333333333333333
333333333333333333333333333333333333333333333333333333333333333333333333333333333333300333333333333333333333333333333333333
333333333333333333333333333333333333333333333333333333333333333333333333333333003303300033333333333333333333333333333333333
333333333333333333333333333333333333333333333333333333333333333333333333333333030003300003333333333333333333333333333333333
333333333333333333333333333333333333333333333333333333333333333333333333333333000003300003333333333333333333333333333333333
333333333333333333333333333333333333333333333333333333333333333333333333303333033333300000033333333333333333333333333333333
333333333333333333333333333333333333333333333333333333333333333333333333303333333303300000003333333333333333333333333333333
333333333333333333333333333333333333333333333333333333333333333333333333333333333303300000000333333333333333333333333333333
333333333333333333333333333333333333333333333333333333333333333333333333333333333303300000000333333333333333333333333333333
333333333333333333333333333333333333333333333333333333333333333333333333333333333333300000000033333333333333333333333333333
333333333333333333333333333333333333333333333333333333333333333333333333333333333333300000000003333333333333333333333333333
333333333333333333333333333333333333333333333333333333333333333333333333333333333333300000000000033333333333333333333333333
333333333333333333333333333333333333333333333333333333333333333333333333333333333333300000000000000333333333333333333333333
333333333333333333333333333333333333333333333333333333333330033333333333333333333333300000000000003333333333333333333333333
333333333333333333333333333333333333333333333333333333333000003333333333333333333333300000000000003333333333333333333333333
333333333333333333333333333333333333333333333333333333330000003333333333333333333333300000000000033333333333333333333333333
333333333333333333333333333333333333333333333333333333333000003333333333333333333303300000000000030333333333333333333333333
333333333333333333333333333333333333333333333333333333333000033333333333333333333303300000000000000003333333333333333333333
333333333333333333333333333333333333333333333333333333333333333333333333333333333003300000300000000000333333333333333333333
333333333333333333333333333333333333333333333333333333333333333333333333333333333003300003333000000000333333333333333333333
333333333333333333333333333333333333333333333333333333333333333333333333333333333003300003333000000000033333333333333333333
333333333333333333333333333333333333333333333333333333333333333333333333333333333333300000330000000000033333333333333333333
333333333333333333333333333333333333333333333333333333333333333000000033333333333333300000000000000000003333333333333333333
333333333333333333333333333333333333333333333333333333333333300000000000333333333333333000000000000000000333333333333333333
333333333333333333333030300000033333333333333333333333333333000000000000333333333333333300000000000000003333333333333333333
333333333333333333330000000000033333333333333333333333333333300000000000033333333333333300000000000000003333333333333333333
333333333333333333300000000000003333333333333333333333333333330000000000033333333333333000000000000000033333333333333333333
333333333333333333300000000000003333333333333333333333333333330030000000033333333333300000000000000000333333333333333333333
333333333333333333300000000000003333333333333333333333333333330030000000003333333333300000000000000000333333333333333333333
333333333333333333330000000000003333333333333333333333333003333333000000000333333333300000000000000003333333333333333333333
333333333333333333330000000000000333333333333333333333333000033333300000000003333333330000000000000003333333333333333333333
333333333333333333300000000000000033333333333333333333330000033333300000000000333333330000000000000033333333333333333333333
333333333333333333300000000000000033333333333333333333300000033333300000000000003333330000000000000333333333333333333333333
333333333333333333000000000000000033333333333333333333300000000333300000000000003333333000000000003333330000000333333333333
333333333333333333300000000000000333333333333333333333330000000000000000000000000333330000000000003333333000000333333333333
333333333333333333330000000000000333333333333333333333333000000000000000000000000333333000000000033333333333000333333333333
333333333333333333333000000030033333333333333333333333333000000000000000000000000033330000000000333333333300000333333333333
333333333333333333333330000000333333333333333333333333333000000000000000000000000003300000000003333333330000000333333333333
333333333333333333333333300000333333333333333333333333333000000000000000000000000000000000000003333333300000000333333333333
333333333333333333333333300000333333333333333333333333333000000000000000000000000000000000000033333333330033333333333333333
333333333333333333333330000000033333333333333333333333330000000000000000000000000000000000000033333333330003333333333333333
333333333333333333333330000000000333333333333333333333333000000000000000000000000000000000000333333333333303333333333333333
333333333333333333333333000000000000033333333333333333333300000000000000000000000000000000000333333333333333333333333333333
333333333333333333333333300000000000000000333333333333333300000000000000000000000000000000000333333333333333333333333333333
333333333333333333333333300000000000000000033333333333333330300000000000000000000000000000000003333303333333333333333333333
333333333333333333333333300000000000000000003333333333333330000000000000000000000000000000000000000000333333333333333333333
333333333333333333333333000000000000000000000333333303333300000000000000000000000000000000000000000000333333333333333333333
333333333333333333333333300000000000000000000333333000333330000000000000000000000000000000000000000003333333333333333333333
333333333333333333333333330000000000000000003333333000033300000000000000000000000000000000000000000333333333333333333333333
333333333333333333333333330000000000000000003333333000033330000000000000000000003333300000000000003333333333333333333333333
333333333333333333333333333000000000000000003333333000333333000000000000000000333333333000000000333333333333333333333333333
333333333333333333333333333300000000000000003333333303333333330000000000000003333333333300000033333333333333333333333333333
333333333333333333333333333300000000000000003333333333333333333000000003333333333333003300003333333333333333333333333333333
333333333333333333333333333330000000000000003333333333333333333000000033333333333300000000003333333333333333333333333333333
333333333333333333333333333330000000000000003333333333333333333000000333333333333300000000333333333333333333333333333333333
333333333333333333333333333330000000000000033333333333333333333000003333333333333330000000333333333333333333333333333333333
333333333333333333333333333333000000000000033333333333333333333000033333333333333333000000333333333333333333333333333333333
333333333333333333333333333333000000000000033333333333333333033000033333333333333333330003333333333333333333333333333333333
333333333333333333333333333333333000000000033333333333333300000000033333333333333333333333333333333333333333333333333333333
333333333333333333333333333333333333000000003333333333330000000000033333333333333333333333333333333333333333333333333333333
333333333333333333333333333333333333330000003333300000000000000000033333333333333330033333333333333333333333333333333333333
333333333333333333333333333333333333330000033333300000000000000000003333333333333330000333333333333333333333333333333333333
333333333333333333333333333333333333333000333330000000000000000000003333333333333330000333333333333333333333333333333333333
333333333333333333333333333333333333333300333300000000000000000000003333333333333333333333333333333333333333333333333333333
333333333333333333333333333333333033333300333300000000000000000000003333333333333333333333333333333333333333333333333333333
333333333333333333333333333333333333333303333300000000000000000000003333333333333333333333333333333333333333333333333333333
333333333333333333333333333333333333333333333300000000000000000000003333333333333333333333333333333333333333333333333333333
333333333333333333333333333333333333333333333000000000000000000000033333330333333333333333333333333333333333333333333333333
333333333333333333333333333333333333333333333000000000000000000000033333300033333333333333333333333333333333333333333333333
333333333333333333333333333333333333333333333000000000000000000000033333333333333333333333333333333333333333333333333333333
333333333333333333333333333333333333333333333000000000000000000000033333333333333333333333333333333333333333333333333333333
333333333333333333333333333333333333333333333000000000000300000000033333333333333333333333333333333333333333333333333333333
333333333333333333333333333333333333333333333000000000003330000000033333333333333333333333333333333333333333333333333333333
333333333333333333333333333333333333333333333300000000033330000000333333333333333333333333333333333333333333333333333333333
333333333333333333333333333333333333333333333300000000333330000003333333333333333333333333333333333333333333333333333333333
333333333333333333333333333333333333333333333330000000333333000333333333333333333333333333333333333333333333333333333333333
333333333333333333333333333333333333333333333333000000333333033333333333333333333333333333333333333333333333333333333333333
333333333333333333333333333333333333333333333333300000333333333333333333333333333333333333333333333333333333333333333333333
333333333333333333333333333333333333333333333333300000333333333333333333333333333333333333333333333333333333333333333333333
333333333333333333333333333333333333333333333333330003333333333333333333333333333333333333333333333333333333333333333333333
333333333333333333333333333333333333333333333333333003333333333333333333333333333333333333333333333333333333333333333333333
333333333333333333333333333333333333333333333333333333333333333333333333333333333333333333333333333333333333333333333333333
333333333333333333333333333333333333333333333333333333333333333333333333333333333333333333333333333333333333333333333333333
333333333333333333333333333333333333333333333333333333333333333333333333333333333333333333333333333333333333333333333333333
333333333333333333333333333333333333333333333333333333333333333333333333333333333333333333333333333333333333333333333333333
333333333333333333333333333333333333333333333333333333333333333333333333333333333333333333333333333333333333333333333333333
333333333333333333333333333333333333333333333333333333333333333333333333333333333333333333333333333333333333333333333333333
333333333333333333333333333333333333333333333333333333333333333333333333333333333333333333333333333333333333333333333333333
333333333333333333333333333333333333333333333333333333333333333333333333333333333333333333333333333333333333333333333333333
333333333333333333333333333333333333333333333333333333333333333333333333333333333333333333333333333333333333333333333333333
333333333333333333333333333333333333333333333333300033333333333333333333333333333333333333333333333333333333333333333333333
333333333333333333333333333333333333333333333333333333333333333333333333333333333333333333333333333333333333333333333333333
333333333333333333333333333333333333333333333333333333333333333333333333333333333333333333333333333333333333333333333333333
333333333333333333333333333333333333333333333333333333333333333333333333333333333333333333333333333333333333333333333333333
54 50
118 123